⣿⣿⣿⣿⣿⣿⣿⣿⣿⣿⣿⣿⡿⠟⠋⠉⠉⠄⠐⠠⢀⠄⠄⠄⢀⡘⢦⡀⢀
⣿⣿⣿⣿⣿⣿⣿⣿⣿⣿⣿⡿⢋⣤⣦⣤⣶⣶⣶⣦⡄⠄⠑⠄⠄⠐⠑⠄⣽⣷
⣿⣿⣿⣿⣿⣿⣿⣿⣿⣿⣿⢱⣿⣿⣿⣿⣿⣿⣿⣿⣿⣆⠄⠄⠄⠄⠄⢸⣿⣿
⣿⣿⣿⣿⣿⣿⣿⣿⣿⣿⡇⠁⢨⣿⣿⣿⣿⣿⣿⣿⡿⠗⠄⠄⠄⠄⠄⠸⣿⣿
⣿⣿⣿⣿⣿⣿⣿⣿⣿⣿⠏⠈⡀⠄⠠⠄⠄⠄⠄⢙⢗⡀⠄⣠⡀⠄⠄⠄⢸⣿
⣿⣿⣿⣿⣿⣿⣿⣿⣿⣷⡘⠄⠄⠄⣠⡀⡄⠄⠄⢎⣿⡶⢶⠄⡃⠄⠄⠄⣼⣿
⣿⣿⣿⣿⣿⣿⣿⣿⣿⣿⣧⠁⠁⠈⠉⠉⢚⣍⣩⡀⠄⢀⠄⠺⠄⠄⠄⠄⣿⣿
⣿⣿⣿⣿⣿⣿⣿⣿⣿⣿⣿⡄⠄⢒⡛⡛⠛⠛⢿⡁⠄⠉⠄⠄⠄⣠⡄⠸⣿⣿
⣿⣿⣿⣿⣿⣿⣿⣿⣿⣿⣿⣧⠄⠉⢉⡉⡉⠁⠄⠁⢠⡎⠄⣀⢰⣿⠁⠄⢿⣿
⣿⣿⣿⣿⣿⣿⣿⣿⣿⣿⣿⣿⣷⡄⠄⠄⠄⠄⠄⠄⢼⡇⢢⣏⠄⠄⠄⠄⣸⣿
⣿⣿⡿⠻⣿⣿⣿⣿⣿⣿⣿⡿⠛⠁⠄⠄⠄⠄⠄⠄⠙⠁⢠⣿⣷⣄⣀⠄⣿⣿
⣏⢀⠄⠄⢈⣯⣿⣿⣿⣿⣿⠇⠄⠄⠄⠄⠄⠄⠄⠄⠄⠄⣼⣿⣿⣿⣿⣿⣿⣿
⡟⠛⠛⢛⣟⡛⠛⠛⣿⣿⣿⠄⠄⠄⠄⠄⠄⠄⠄⠄⢀⡸⣿⣿⣿⣿⢿⣿⣿⣿
⠁⠄⠄⢈⠉⠁⠄⠄⣹⣿⣿⠄⠄⠄⠄⠄⠄⠄⠄⢠⣾⣷⣿⣿⣭⣾⣿⣿⣿⣿
⠄⠄⠄⠄⠁⠄⠄⠄⢿⣿⣿⠄⠄⠄⠄⠄⠄⠄⢠⣿⣿⣿⣿⣿⡿⢻⣿⣿⣟⣿